maze1(40X30)
1111111111111111111111111111111111111111
1000011000000000000000000000000000000011
1001011011111111111011001111101111100001
1001011010000000000001010000000000101001
1100011010111111111101010000000001101001
1001000010000000000101010010111111101011
1001011010011110000101010110000000001001
1101011010011010001101000010111111111101
1001011011100000101001010010101111111011
1001011000100001101111010000101000001001
1011000110101111100000010110101010101101
1001011110101110111111010110101011111001
1101000000100000000001010010101000100011
1001111110101111111101001010101010001001
1000000000101000000101010000001111111101
1001111111101111110101010010100010001101
1101110000000000010001010110111101101011
1001000111111111010100011010110010001011
1001001000000001010001011010100011111011
1011110111111001010101011010010100000001
1000010110000101010101010010110101111101
1011010000111101010000010100110100000011
1001001011000001010101000110000101111101
1001001000110111010101010010110100101001
1101010111100101110111011010010110101101
1001000000011100000000011010010111101011
1011010110000101111110010011010000001001
1001011000110001000011111001110111101101
1100001111111110000000000000001000001001
1111111111111111111111111111111111111111


maze2(40X30)
1111111111111111111111111111111111111111
1001000000000000000010000010000000000001
1001111110111111010000100010011111110001
1101000000000001011111111010100000001001
1000010101011101010000001010110111101001
1011010101010001010111101010000000001001
1001010101011101010100101000111110000001
1101010001000101010110101010000011100101
1001010101000101010100101010000010010001
1011010101011101010100101010111011001001
1001010101000101010110101010001010011001
1001000001011101010000101010101010000101
1101011111000001011111001010101010101101
1001010000010101000000001010101010101001
1011010111111101111011110010101010110001
1001010100000001000010000010101010000001
1001010111110111111011110010101111111101
1101010000000010000000001010100000000001
1000010111111100111111101010101111111101
1011010100010100100000101010100101000001
1001110101010100111010101010100000010101
1101000101010100001010100010111111111101
1001011101010101111010101010000000000001
1011010101110100001010101010111111111101
1001010100010101111010100010100000000101
1101010110010100000011101010111111110101
1001010100110100000000001010000000000101
1100010100100111111111101001111111111101
1001010000010000000000001000000000000001
1111111111111111111111111111111111111111


maze3(40X30)
1111111111111111111111111111111111111111
1001000000110000000000000000000000000001
1101111110110111111111110110111111110001
1000001000010000000111110110100000011001
1101111101011111101111110100101111101001
1101010101010100001111110011001000101001
1000010101010010110000100000111110101001
1111010001011010110101101011100000001101
1001010101001010110110101000001111010001
1010010101010110010011001110101101011101
1011010101011101100110101110101000010101
1001100101110001011100010110101010010101
1101110011010111010011111010101010110101
1000011000110001010100000011101010101001
1011101111111101010101111001100111110101
1000110100000000000101001110001100000101
1011011111110111111101100000101000111101
1011101100000010000000000101101010000001
1011110110111110111111110101011011101101
1011110101011110100000010100100011001101
1001110101011110111101110111100110011101
1100000001011110000000000111110111010001
1001011101000000111111010100000000000001
1011010101110110000001010101101111011111
1001010100010001111101010101100100000001
1101010110110111000101010000110101010101
1001010100101100110101010110111101001101
1100010101101001110011110110001101111101
1001010000000011110111100000100110000001
1111111111111111111111111111111111111111
